█,█,█,█,█,█,█,█,█,█,█,█,█,█,█,█,█,█,█,█,█,█,█,█,█,█,█,█,█,█,█,█,█,█,█,█,█,█,█,█,█
█,░,●,●,●,●,●,●,●,●,●,●,●,●,●,●,●,●,●,●,●,●,●,●,●,●,●,●,●,●,●,●,●,●,●,●,●,●,●,░,█
█,█,█,█,█,█,█,●,█,●,●,█,█,█,█,█,█,█,█,●,█,█,█,●,█,●,█,█,█,●,█,●,█,█,█,●,█,█,█,●,█
█,●,●,●,█,●,●,●,█,●,●,●,●,●,█,●,●,●,●,●,●,●,█,●,●,●,●,●,●,●,●,●,█,●,●,●,●,●,█,●,█
█,█,█,█,█,●,█,█,█,█,●,●,█,█,█,●,█,█,█,█,█,█,█,█,█,█,█,█,█,●,█,●,█,█,█,█,█,█,█,●,█
█,●,●,●,█,●,●,●,●,●,●,●,●,●,●,●,●,●,●,●,█,●,●,●,█,●,█,●,█,●,█,●,●,●,█,●,█,●,●,●,█
█,●,█,█,█,●,█,█,█,●,●,█,█,█,█,█,█,█,█,●,█,█,█,█,█,█,█,●,█,●,█,●,█,█,█,█,█,█,█,█,█
█,●,●,●,█,●,●,●,●,●,●,●,●,●,●,●,●,●,●,●,●,●,█,●,●,●,●,●,●,●,●,●,●,●,●,●,●,●,█,●,█
█,█,█,█,█,█,█,█,█,●,●,█,█,█,█,█,█,●,█,█,█,█,█,█,█,█,█,●,█,█,█,●,█,●,█,█,█,█,█,█,█
█,●,●,●,█,●,█,●,●,●,●,●,●,●,●,●,●,●,●,●,●,●,●,●,●,●,●,●,█,●,●,●,█,●,●,●,●,●,●,●,█
█,█,█,█,█,█,█,█,█,█,●,█,█,█,█,●,█,█,█,█,█,●,█,█,█,█,█,█,█,█,█,●,█,█,█,█,█,●,█,█,█
█,●,●,●,●,●,●,●,█,●,●,●,█,●,●,●,●,●,█,●,●,●,●,●,●,●,●,●,●,●,●,●,●,●,●,●,●,●,●,●,█
█,█,█,●,█,█,█,●,█,█,●,█,█,█,█,●,█,█,█,●,█,█,█,●,█,█,█,●,█,●,█,●,█,●,█,█,█,█,█,●,█
█,●,●,●,●,●,●,●,●,●,●,●,●,●,█,●,●,●,█,●,●,●,●,●,█,●,█,●,●,●,●,●,●,●,●,●,●,●,█,●,█
█,█,█,█,█,█,█,█,█,●,●,●,█,█,█,●,█,●,█,█,█,█,█,█,█,█,█,●,█,█,█,●,█,█,█,█,█,█,█,█,█
█,●,●,●,●,●,█,●,●,●,●,●,█,●,█,●,●,●,●,●,█,●,●,●,●,●,●,●,●,●,●,●,●,●,●,●,●,●,●,●,█
█,●,█,●,█,█,█,█,█,█,●,█,█,●,█,█,░,░,░,░,░,░,░,░,█,█,█,█,█,●,█,●,█,●,█,█,█,●,█,●,█
█,●,●,●,●,●,●,●,█,●,●,●,●,●,●,●,░,░,░,░,░,░,░,░,●,●,█,●,●,●,●,●,●,●,●,●,●,●,█,●,█
█,█,█,█,█,█,█,█,█,█,●,█,█,●,█,●,░,░,░,░,░,░,░,░,█,●,█,●,█,█,█,●,█,●,█,█,█,█,█,█,█
█,●,●,●,●,●,█,●,█,●,●,●,●,●,█,●,░,░,░,░,░,░,░,░,●,●,█,●,●,●,█,●,█,●,●,●,█,●,●,●,█
█,●,●,●,●,●,●,●,●,●,●,●,●,●,●,●,░,░,░,░,░,░,░,░,●,●,●,●,●,●,●,●,●,●,●,●,●,●,●,●,█
█,●,●,●,●,●,█,●,█,●,●,●,●,●,█,●,░,░,░,░,░,░,░,░,●,●,█,●,●,●,█,●,█,●,●,●,█,●,●,●,█
█,█,█,█,█,█,█,█,█,█,●,█,█,●,█,●,░,░,░,░,░,░,░,░,█,●,█,●,█,█,█,●,█,●,█,█,█,█,█,█,█
█,●,●,●,●,●,●,●,█,●,●,●,●,●,●,●,░,░,░,░,░,░,░,░,●,●,█,●,●,●,●,●,●,●,●,●,●,●,█,●,█
█,●,█,●,█,█,█,█,█,█,●,█,█,●,█,█,░,░,░,░,░,░,░,░,█,█,█,█,█,●,█,●,█,●,█,█,█,●,█,●,█
█,●,●,●,●,●,█,●,●,●,●,●,█,●,█,●,●,●,●,●,█,●,●,●,●,●,●,●,●,●,●,●,●,●,●,●,●,●,●,●,█
█,█,█,█,█,█,█,█,█,●,●,●,█,█,█,●,█,●,█,█,█,█,█,█,█,█,█,●,█,█,█,●,█,█,█,█,█,█,█,█,█
█,●,●,●,●,●,●,●,●,●,●,●,●,●,█,●,●,●,█,●,●,●,●,●,█,●,█,●,●,●,●,●,●,●,●,●,●,●,█,●,█
█,█,█,●,█,█,█,●,█,█,●,█,█,█,█,●,█,█,█,●,█,█,█,●,█,█,█,●,█,●,█,●,█,●,█,█,█,█,█,●,█
█,●,●,●,●,●,●,●,█,●,●,●,█,●,●,●,●,●,█,●,●,●,●,●,●,●,●,●,●,●,●,●,●,●,●,●,●,●,●,●,█
█,█,█,█,█,█,█,█,█,█,●,█,█,█,█,●,█,█,█,█,█,●,█,█,█,█,█,█,█,█,█,●,█,█,█,█,█,●,█,█,█
█,●,●,●,█,●,█,●,●,●,●,●,●,●,●,●,●,●,●,●,●,●,●,●,●,●,●,●,█,●,●,●,█,●,●,●,●,●,●,●,█
█,█,█,█,█,█,█,█,█,●,●,█,█,█,█,█,█,●,█,█,█,█,█,█,█,█,█,●,█,█,█,●,█,●,█,█,█,█,█,█,█
█,●,●,●,█,●,●,●,●,●,●,●,●,●,●,●,●,●,●,●,●,●,█,●,●,●,●,●,●,●,●,●,●,●,●,●,●,●,█,●,█
█,●,█,█,█,●,█,█,█,●,●,█,█,█,█,█,█,█,█,●,█,█,█,█,█,█,█,●,█,●,█,●,█,█,█,█,█,█,█,█,█
█,●,●,●,█,●,●,●,●,●,●,●,●,●,●,●,●,●,●,●,█,●,●,●,█,●,█,●,█,●,█,●,●,●,█,●,█,●,●,●,█
█,█,█,█,█,●,█,█,█,█,●,●,█,█,█,●,█,█,█,█,█,█,█,█,█,█,█,█,█,●,█,●,█,█,█,█,█,█,█,●,█
█,●,●,●,█,●,●,●,█,●,●,●,●,●,█,●,●,●,●,●,●,●,█,●,●,●,●,●,●,●,●,●,█,●,●,●,●,●,█,●,█
█,█,█,█,█,█,█,●,█,●,●,█,█,█,█,█,█,█,█,●,█,█,█,●,█,●,█,█,█,●,█,●,█,█,█,●,█,█,█,●,█
█,░,●,●,●,●,●,●,●,●,●,●,●,●,●,●,●,●,●,●,●,●,●,●,●,●,●,●,●,●,●,●,●,●,●,●,●,●,●,░,█
█,█,█,█,█,█,█,█,█,█,█,█,█,█,█,█,█,█,█,█,█,█,█,█,█,█,█,█,█,█,█,█,█,█,█,█,█,█,█,█,█
